NO textures/Gem_04.xpm
SO textures/Cloth_06.xpm
WE textures/Gem_16.xpm
EA textures/wet_sponge.xpm

F 164,169,20
C 153,204,255

1111111111111
1S00000000001
1000000000001
1000000000001
1000000000001
1000111100001
11111   11111
