111111111111111111111
101000001000000000001
1111101010111111100011111
    100010100010000000001
    100000000000000000001
1111101011111010111011111
100000101000101000001
101111101011101111111
101000001010100000101
101011111010111110101
101010001010100010101
101110101010101010101
100000101010001010001
111111101011111011101
100000101000100010001
101110101110101110111
101000100S00100010101
101011111111111010101
100010000000000010001
101010111011111111101
101000001111000000001
11111111   111111111
