NO textures/Gem_05.xpm
SO textures/wet_sponge.xpm
WE textures/Cloth_07.xpm
EA textures/Cloth_11.xpm

F 164,169,20
C 153,204,255

111111111111111111111
111110101111101011101
100000000N00000000001
101110000000001111111
101000000000000000101
100000111011111111101
101000001111000000001
111111111111111111111
