1111111111111111111111111111111111
101000000000001C10000C000000000001
1010010100100000101001100000010101
1010010010101010001001E10000010101
1P0000000C00C0000000010000000000C1
1111111111111111111111111111111111