111111111111
111110111111
111110111111
111110111111
111110111111
111110111111
1E000P000001
111110111111
111110111111
111110111111
11111C111111
111110111111
111111111111