111111111111
11111C111111
111110111111
111110111111
111110111111
111110111111
1E0000000001
111110111111
111110111111
111110111111
111110111111
11111P111111
111111111111