1111111111111
1001E000000C1
1000011111011
1P0011C000001
1111111111111